00111110
11100010
1.p*0010
1110*.10
1.11*010
1010.011
1*0x**.1
1000.001
11111111