1111111111111
100010*010*01
10p000*0*0.01
100010*010*01
1111111111111